72,72,72,72,72,72,72,72,72,72,72,72,72,72,72,72,72,72,72,72,72,72,72,72,72,
72,72,72,72,72,72,72,72,72,72,72,72,72,72,72,72,72,72,72,72,72,72,72,72,72,
0,1,2,3,4,1,2,3,4,1,2,3,4,5,72,72,72,72,72,72,72,72,72,72,72,
66,67,68,69,70,67,68,69,70,67,68,69,70,71,72,72,72,72,72,72,72,72,72,72,72,
72,72,72,72,72,72,72,72,72,72,72,72,72,72,72,72,72,72,72,72,72,72,72,72,72,
72,72,72,72,72,72,72,72,72,72,72,72,72,72,72,72,72,72,0,1,5,72,72,72,72,
72,72,72,72,72,72,72,72,72,72,72,72,72,72,72,72,72,72,66,67,71,72,72,72,72,
72,72,72,72,72,72,72,72,72,72,72,72,72,72,72,72,72,72,72,72,72,72,72,72,72,
72,72,72,72,72,72,72,72,72,72,72,72,72,72,72,72,72,72,72,72,72,72,72,72,72,
72,72,72,72,72,72,72,72,72,72,0,1,2,5,72,72,72,72,72,72,72,72,72,72,72,
72,72,72,72,72,72,72,72,72,72,66,67,68,71,72,72,72,72,72,72,72,72,72,72,72,
0,1,2,3,5,72,72,72,72,72,72,72,72,72,72,72,72,72,72,72,72,72,72,72,72,
7,8,9,10,31,72,72,72,72,72,72,72,72,72,72,72,72,72,72,72,72,72,72,72,72,
36,57,58,48,32,72,72,72,72,72,72,72,72,72,72,72,72,0,1,2,3,4,5,72,72,
37,65,65,49,33,72,72,72,72,72,72,72,72,72,72,72,72,66,67,68,69,70,71,72,72,
38,60,61,50,33,72,72,72,72,72,72,72,72,72,72,72,72,72,72,72,72,72,72,72,72,
39,62,63,48,34,72,72,72,72,72,72,72,72,72,72,72,72,72,72,72,72,72,72,72,72,
39,65,65,49,12,0,2,3,4,1,2,3,4,1,2,3,4,1,2,3,4,1,2,3,5,
37,64,65,50,10,11,8,10,11,8,9,10,11,8,9,10,11,8,9,10,11,8,9,10,12,
38,65,65,65,55,56,57,58,59,52,64,54,55,56,57,58,59,53,54,55,56,64,58,59,47,

0,0,0,0,0,0,0,0,0,0,0,0,0,0,0,0,0,0,0,0,0,0,0,0,0,
0,0,0,0,0,0,0,0,0,0,0,0,0,0,0,0,0,0,0,0,0,0,0,0,0,
1,1,1,1,1,1,1,1,1,1,1,1,1,1,0,0,0,0,0,0,0,0,0,0,0,
1,1,1,1,1,1,1,1,1,1,1,1,1,1,0,0,0,0,0,0,0,0,0,0,0,
0,0,0,0,0,0,0,0,0,0,0,0,0,0,0,0,0,0,0,0,0,0,0,0,0,
0,0,0,0,0,0,0,0,0,0,0,0,0,0,0,0,0,0,1,1,1,0,0,0,0,
0,0,0,0,0,0,0,0,0,0,0,0,0,0,0,0,0,0,1,1,1,0,0,0,0,
0,0,0,0,0,0,0,0,0,0,0,0,0,0,0,0,0,0,0,0,0,0,0,0,0,
0,0,0,0,0,0,0,0,0,0,0,0,0,0,0,0,0,0,0,0,0,0,0,0,0,
0,0,0,0,0,0,0,0,0,0,1,1,1,1,0,0,0,0,0,0,0,0,0,0,0,
0,0,0,0,0,0,0,0,0,0,1,1,1,1,0,0,0,0,0,0,0,0,0,0,0,
1,1,1,1,1,0,0,0,0,0,0,0,0,0,0,0,0,0,0,0,0,0,0,0,0,
0,0,0,0,1,0,0,0,0,0,0,0,0,0,0,0,0,0,0,0,0,0,0,0,0,
0,0,0,0,1,0,0,0,0,0,0,0,0,0,0,0,0,1,1,1,1,1,1,0,0,
0,0,0,0,1,0,0,0,0,0,0,0,0,0,0,0,0,1,1,1,1,1,1,0,0,
0,0,0,0,1,0,0,0,0,0,0,0,0,0,0,0,0,0,0,0,0,0,0,0,0,
0,0,0,0,1,0,0,0,0,0,0,0,0,0,0,0,0,0,0,0,0,0,0,0,0,
0,0,0,0,1,1,1,1,1,1,1,1,1,1,1,1,1,1,1,1,1,1,1,1,1,
0,0,0,0,0,0,0,0,0,0,0,0,0,0,0,0,0,0,0,0,0,0,0,0,0,
0,0,0,0,0,0,0,0,0,0,0,0,0,0,0,0,0,0,0,0,0,0,0,0,0,

